Rank,NOC,Gold,Silver,Bronze,Total,Year
17,Egypt,2,1,1,4,1928
16,Egypt,2,1,2,5,1936
16,Egypt,2,2,1,5,1948
40,Egypt,0,0,1,1,1952
30,Egypt,0,1,1,2,1960
33,Egypt,0,1,0,1,1984
46,Egypt,1,1,3,5,2004
81,Egypt,0,0,2,2,2008
56,Egypt,0,3,1,4,2012
75,Egypt,0,0,3,3,2016
54,Egypt,1,1,4,6,2020
52,Egypt,1,1,1,3,2024
