Rank,NOC,Gold,Silver,Bronze,Total,Year
14,Estonia,1,2,0,3,1920
17,Estonia,1,1,4,6,1924
16,Estonia,2,1,2,5,1928
14,Estonia,2,2,3,7,1936
34,Estonia,1,0,1,2,1992
47,Estonia,1,0,2,3,2000
64,Estonia,0,1,2,3,2004
47,Estonia,1,1,0,2,2008
65,Estonia,0,1,1,2,2012
78,Estonia,0,0,1,1,2016
59,Estonia,1,0,1,2,2020
