Rank,NOC,Gold,Silver,Bronze,Total,Year
35,Nigeria,0,0,1,1,1964
43,Nigeria,0,0,1,1,1972
30,Nigeria,0,1,1,2,1984
38,Nigeria,0,3,1,4,1992
32,Nigeria,2,1,3,6,1996
41,Nigeria,1,2,0,3,2000
68,Nigeria,0,0,2,2,2004
57,Nigeria,0,3,2,5,2008
78,Nigeria,0,0,1,1,2016
74,Nigeria,0,1,1,2,2020
